# language_name_wals:	English
# language_name_glotto:	English
# iso639_3:	eng
# year_composed:	NA
# year_published:	1991
# mode:	written
# genre_broad:	conversation
# genre_narrow:	NA
# writing_system:	Latn
# special_characters:	NA
# short_description:	ca
# source:	https://ca.talkbank.org/data-orig/CABNC/KC9/KC9RE00N.cha
# copyright_short:	https://sla.talkbank.org/TBB/ca
# copyright_long:	CABank: MacWhinney, B., & Wagner, J. (2010). Transcribing, searching and data sharing: The CLAN software and the TalkBank data repository. Gesprachsforschung, 11, 154-173.
# sample_type:	whole
# comments:	NA
0 .
Who 's that John John . 619185_619965
Yeah Can you ring him some time after eight or between eight thirty
He ca n't because one of his favourite programmes is on . 630755_632865
Well make it after nine o'clock then It 's going up It could b