# language_name_wals:	English
# language_name_glotto:	English
# iso639_3:	eng
# year_composed:	NA
# year_published:	1974
# mode:	written
# genre_broad:	conversation
# genre_narrow:	NA
# writing_system:	Latn
# special_characters:	NA
# short_description:	phon
# source:	https://phon.talkbank.org/data-orig/Eng-NA/ComptonPater/Sean/020904.cha
# copyright_short:	https://sla.talkbank.org/TBB/phon
# copyright_long:	Phon and PhonBank: Rose, Y., & MacWhinney, B. (2014). The PhonBank Project: Data and software-assisted methods for the study of phonology and phonological development. In Durand J., Gut U., & Kristoffersen, G. (Eds.), The Oxford handbook of corpus phonology (pp. 380-401). Oxford, UK: Oxford University Press. Note: Please also acknowledge this grant support for PhonBank -- NIH-NICHHD RO1-HD051698.
# sample_type:	whole
# comments:	NA
I put the glove on me so it can't burn on me ; I put my thumb .
I wanna clean one to cut my eggs .
Mommy is that a newspaper ?
that's dirty .
I want more eggy 