# language_name_wals:	English
# language_name_glotto:	English
# iso639_3:	eng
# year_composed:	NA
# year_published:	1992
# mode:	written
# genre_broad:	conversation
# genre_narrow:	NA
# writing_system:	Latn
# special_characters:	NA
# short_description:	ca
# source:	https://ca.talkbank.org/data-orig/CABNC/KBJ/KBJRE009.cha
# copyright_short:	https://sla.talkbank.org/TBB/ca
# copyright_long:	CABank: MacWhinney, B., & Wagner, J. (2010). Transcribing, searching and data sharing: The CLAN software and the TalkBank data repository. Gesprachsforschung, 11, 154-173.
# sample_type:	whole
# comments:	NA
It 's not doing anything Is it the right way round The light 's not
It is .
is on .
0 .
Wait a minute then Tell me in a bit Emma 