# language_name_wals:	English
# language_name_glotto:	English
# iso639_3:	eng
# year_composed:	NA
# year_published:	2001
# mode:	written
# genre_broad:	conversation
# genre_narrow:	NA
# writing_system:	Latn
# special_characters:	NA
# short_description:	CHILDES
# source:	https://childes.talkbank.org/data-orig/Clinical-MOR/Conti/Conti4/TD-spontaneous/s23.cha
# copyright_short:	https://sla.talkbank.org/TBB/childes
# copyright_long:	MacWhinney, B. (2000). The CHILDES Project: Tools for analyzing talk. Third Edition. Mahwah, NJ: Lawrence Erlbaum Associates.
# sample_type:	whole
# comments:	NA
&~www .
he's always trying to be the best in the +...
<trying to make> his voice just irritates you_all the time !
0 tries to make out that he knows everything when he doesn't .
and then he'll just be extremely annoying .
&~www 