# language_name_wals:	Persian
# language_name_glotto:	Western Farsi
# ISO_639-3:	pes
# year_composed:	NA
# year_published:	2016
# mode:	written
# genre_(broad):	non-fiction
# genre_(narrow):	prepared_speeches
# writing_system:	Arab
# special_characters:	NA
# short_description:	OpenSubtitles2018
# source:	https://object.pouta.csc.fi/OPUS-OpenSubtitles/v2018/raw/fa.zip
# copyright_short:	http://www.opensubtitles.org/
# copyright_long:	http://www.opensubtitles.org/ P. Lison and J. Tiedemann, 2016, OpenSubtitles2016: Extracting Large Parallel Corpora from Movie and TV Subtitles. In Proceedings of the 10th International Conference on Language Resources and Evaluation (LREC 2016)
# sample_type:	whole
# comments:	NA

وقتی یه نفر قدرت زیادی رو در اختیار داشته باشه
استفاده درست و نادرست از اون قدرت خیلی مهم میشه
آیا برای اهداف بزرگ استفاده میکنه
یا برای موارد شخصی
یا برای خرابی و ویرانی
"Apocalypse :
