# language_name_wals:	Hebrew (Modern)
# language_name_glotto:	Modern Hebrew
# ISO_6393:	heb
# year_composed:	NA
# year_published:	2014
# mode:	written
# genre_broad:	technical
# genre_narrow:	NA
# writing_system:	Hebr
# special_characters:	NA
# short_description:	Ubuntu
# source:	https://object.pouta.csc.fi/OPUS-Ubuntu/v14.10/raw/he.zip
# copyright_short:	http://opus.nlpl.eu/Ubuntu.php
# copyright_long:	http://opus.nlpl.eu/Ubuntu.php J. Tiedemann, 2012, Parallel Data, Tools and Interfaces in OPUS. In Proceedings of the 8th International Conference on Language Resources and Evaluation (LREC 2012)
# sample_type:	whole
# comments:	NA

שליטה בסוכן ניהול המודם
מדיניות המערכת מונעת את השליטה במנהל המודם.
שחרור ושליטה בהתקן פס רחב נייד
מדיניות המערכת מונעת שחרור או שליטה בהתקן הפס הרחב הנייד.
הוספה, שינוי ומחיקה של אנשי קשר מהפס הרחב הנייד