# language_name_wals:	Hebrew (Modern)
# language_name_glotto:	Modern Hebrew
# iso639_3:	heb
# year_composed:	NA
# year_published:	NA
# mode:	written
# genre_broad:	technical
# genre_narrow:	NA
# writing_system:	Hebr
# special_characters:	NA
# short_description:	PHP
# source:	https://object.pouta.csc.fi/OPUS-PHP/v1/raw/he.zip
# copyright_short:	http://opus.nlpl.eu/PHP.php
# copyright_long:	http://opus.nlpl.eu/PHP.php J. Tiedemann, 2012, Parallel Data, Tools and Interfaces in OPUS. In Proceedings of the 8th International Conference on Language Resources and Evaluation (LREC 2012)
# sample_type:	whole
# comments:	NA

骠PHP


This means that in i.e. the default "C" locale, characters such as umlaut-A (ĩ will not be converted.
㥢1. strtolower() example


䡠

쮲줼 / A
