# language_name_wals:	Hebrew (Modern)
# language_name_glotto:	Modern Hebrew
# iso639_3:	heb
# year_composed:	NA
# year_published:	NA
# mode:	written
# genre_broad:	technical
# genre_narrow:	NA
# writing_system:	Hebr
# special_characters:	NA
# short_description:	KDE4
# source:	https://object.pouta.csc.fi/OPUS-KDE4/v2/raw/he.zip
# copyright_short:	http://opus.nlpl.eu/KDE4.php
# copyright_long:	http://opus.nlpl.eu/KDE4.php J. Tiedemann, 2012, Parallel Data, Tools and Interfaces in OPUS. In Proceedings of the 8th International Conference on Language Resources and Evaluation (LREC 2012)
# sample_type:	whole
# comments:	NA

אין אפשרות לפתוח את מקור המדיה.
סוג מקור לא תקין.
אין אפשרות לאתר את מקור המדיה.
אין אפשרות לפתוח את התקן השמע. ההתקן כבר בשימוש.
אזהרה: נראה כי החבילה gstreamer0. 10- plugins- good אינה מותקנת מספר אפשריות בוטלו.
אזהרה: נראה כי תוספי GStreamer הבסיסיים אינם מותקנים. התמיכה בשמע ובוידאו בוטלה לחלוטין.