# language_name_wals:	Georgian
# language_name_glotto:	Georgian
# iso639_3:	kat
# year_composed:	NA
# year_published:	2014
# mode:	written
# genre_broad:	technical
# genre_narrow:	NA
# writing_system:	Geor
# special_characters:	NA
# short_description:	Ubuntu
# source:	https://object.pouta.csc.fi/OPUS-Ubuntu/v14.10/raw/ka.zip
# copyright_short:	http://opus.nlpl.eu/Ubuntu.php
# copyright_long:	http://opus.nlpl.eu/Ubuntu.php J. Tiedemann, 2012, Parallel Data, Tools and Interfaces in OPUS. In Proceedings of the 8th International Conference on Language Resources and Evaluation (LREC 2012)
# sample_type:	whole
# comments:	NA

`'like this`" and "'
yes
no
(C)(C)
Report translation bugs to <\.\.\.>