# language_name_wals:	Turkish
# language_name_glotto:	Turkish
# iso639_3:	tur
# year_composed:	NA
# year_published:	NA
# mode:	written
# genre_broad:	technical
# genre_narrow:	NA
# writing_system:	Latn
# special_characters:	NA
# short_description:	KDE4
# source:	https://object.pouta.csc.fi/OPUS-KDE4/v2/raw/tr.zip
# copyright_short:	http://opus.nlpl.eu/KDE4.php
# copyright_long:	http://opus.nlpl.eu/KDE4.php J. Tiedemann, 2012, Parallel Data, Tools and Interfaces in OPUS. In Proceedings of the 8th International Conference on Language Resources and Evaluation (LREC 2012)
# sample_type:	whole
# comments:	NA

Ev dizininizde yetersiz disk alanı ile çalışıyorsunuz (kalan boş disk alanı% 2%,% 1 MB).
Dosya Yöneticisini Aç
Hiçbir Şey Yapma
Uyarıyı Pasifleştir
Boş alan miktarı bu düzeye inerse yeniden uyar
MB