# language_name_wals:	German
# language_name_glotto:	German
# ISO_6393:	deu
# year_composed:	NA
# year_published:	2016
# mode:	written
# genre_broad:	non-fiction
# genre_narrow:	prepared_speeches
# writing_system:	Latn
# special_characters:	NA
# short_description:	OpenSubtitles2018
# source:	https://object.pouta.csc.fi/OPUS-OpenSubtitles/v2018/raw/de.zip
# copyright_short:	http://www.opensubtitles.org/
# copyright_long:	http://www.opensubtitles.org/ P. Lison and J. Tiedemann, 2016, OpenSubtitles2016: Extracting Large Parallel Corpora from Movie and TV Subtitles. In Proceedings of the 10th International Conference on Language Resources and Evaluation (LREC 2016)
# sample_type:	whole
# comments:	NA

Geh nach Arborlon.

Es kostet mich meine ganze Kraft, um meine Anwesenheit vor ihm zu verbergen.
Der Baum hat die Elfen-Prinzessin erwählt, um seinen Samen ins Blutfeuer zu tragen.
Dies bleibt nicht ohne Konsequenzen.
Töte die Prinzessin, bevor sie aufbricht.
Der letzte Funken Hoffnung der Elfen wird mit ihr erlöschen.