# language_name_wals:	Greek (Modern)
# language_name_glotto:	Modern Greek
# ISO_6393:	ell
# year_composed:	NA
# year_published:	2014
# mode:	written
# genre_broad:	technical
# genre_narrow:	NA
# writing_system:	Grek
# special_characters:	NA
# short_description:	Ubuntu
# source:	https://object.pouta.csc.fi/OPUS-Ubuntu/v14.10/raw/el.zip
# copyright_short:	http://opus.nlpl.eu/Ubuntu.php
# copyright_long:	http://opus.nlpl.eu/Ubuntu.php J. Tiedemann, 2012, Parallel Data, Tools and Interfaces in OPUS. In Proceedings of the 8th International Conference on Language Resources and Evaluation (LREC 2012)
# sample_type:	whole
# comments:	NA

Καταγραφή του κωδικού κρυπτογράφησης
Για να κρυπτογραφηθεί ο προσωπικός σας κατάλογος ή ο φάκελος «Ιδιωτικό» (Private ), δημιουργήθηκε αυτόματα μια ισχυρή κωδική φράση. Συνήθως ο προσωπικός σας φάκελος ξεκλειδώνει με τον κωδικό του χρήστη σας, αλλά αν κάποτε θελήσετε να ανακτήσετε αυτόν τον κατάλογο, θα χρειαστείτε τη φράση αυτή. Παρακαλώ, εκτυπώστε ή αντιγράψτε την και αποθηκεύστε την σε ασφαλές μέρος. Αν κάνετε κλικ στο «Εκτέλεση αυτής της ενέργειας τώρα», εισάγετε τον κωδικό σύνδεσής σας στην προτροπή «Κωδική φράση» (Passphrase) και μπορείτε να προβάλλετε την τυχαία δημιουργημένη κωδική φράση. Αλλιώς, θα χρειαστεί να εκτελέσετε την εντολή "ecryptfs-unwrap-passphrase" από τη γραμμή εντολών ώστε να ανακτήσετε και να καταγράψετε τη δημιουργηθείσα κωδική φράση σας.
Πρόσβαση στα προσωπικά σας δεδομένα
Ρυθμίστε τον κρυπτογραφημένο προσωπικό σας κατάλογο