# language_name_wals:	Greek (Modern)
# language_name_glotto:	Modern Greek
# iso639_3:	ell
# year_composed:	NA
# year_published:	NA
# mode:	written
# genre_broad:	technical
# genre_narrow:	NA
# writing_system:	Grek
# special_characters:	NA
# short_description:	KDE4
# source:	https://object.pouta.csc.fi/OPUS-KDE4/v2/raw/el.zip
# copyright_short:	http://opus.nlpl.eu/KDE4.php
# copyright_long:	http://opus.nlpl.eu/KDE4.php J. Tiedemann, 2012, Parallel Data, Tools and Interfaces in OPUS. In Proceedings of the 8th International Conference on Language Resources and Evaluation (LREC 2012)
# sample_type:	whole
# comments:	NA

Σύστημα υποστήριξης GStreamer του Phonon
PulseAudio
Το PulseAudio είναι ένας εξυπηρετητής ήχου για συστήματα POSIX και Win32. Ένας εξυπηρετητής ήχου είναι βασικά ένας διαμεσολαβητής για τις εφαρμογές ήχου. Σας επιτρέπει προχωρημένες λειτουργίες με τα δεδομένα ήχου καθώς βρίσκεται ανάμεσα στην εφαρμογή και την κάρτα ήχου σας. Λειτουργίες όπως η μεταφορά ήχου σε άλλο μηχάνημα, η αλλαγή της μορφής δειγματοληψίας ή του αριθμού των καναλιών και η μείξη πολλαπλών ήχων σε έναν, επιτυγχάνονται εύκολα με τη χρήση ενός εξυπηρετητή ήχου.
TODO: προσθήκη πληροφοριών pulseaudio!