# language_name_wals:	Russian
# language_name_glotto:	Russian
# iso639_3:	rus
# year_composed:	NA
# year_published:	NA
# mode:	written
# genre_broad:	professional
# genre_narrow:	NA
# writing_system:	Cyrl
# special_characters:	NA
# short_description:	MultiUN
# source:	https://object.pouta.csc.fi/OPUS-MultiUN/v1/raw/ru.zip
# copyright_short:	http://opus.nlpl.eu/MultiUN.php
# copyright_long:	http://opus.nlpl.eu/MultiUN.php J. Tiedemann, 2012, Parallel Data, Tools and Interfaces in OPUS. In Proceedings of the 8th International Conference on Language Resources and Evaluation (LREC 2012)
# sample_type:	whole
# comments:	NA
Пятьдесят девятая сессия
Повестка дня пятьдесят девятой сессии Генеральной Ассамблеи
Добавление
На своем 95-м пленарном заседании 5 мая 2005 года Генеральная Ассамблея по предложению Генерального секретаря (A/59/240, пункт 6) постановила включить в раздел I (Организационные, административные и прочие вопросы) повестки дня своей пятьдесят девятой сессии в качестве подпункта (k) пункта 17 повестки дня (Назначения для заполнения вакансий во вспомогательных органах и другие назначения) следующий подпункт:
k) Подтверждение назначения Администратора Программы развития Организации Объединенных Наций.