# language_name_wals:	Basque
# language_name_glotto:	Basque
# ISO_639-3:	eus
# year_composed:	NA
# year_published:	1981
# mode:	written
# genre_(broad):	non-fiction
# genre_(narrow):	prepared speeches
# writing_system:	Latn
# special_characters:	NA
# short_description:	OpenSubtitles2018
# source:	https://object.pouta.csc.fi/OPUS-OpenSubtitles/v2018/raw/eu.zip
# copyright_short:	NA
# copyright_long:	NA
# sample_type:	whole
# comments:	P. Lison and J. Tiedemann, 2016, OpenSubtitles2016: Extracting Large Parallel Corpora from Movie and TV Subtitles. In Proceedings of the 10th International Conference on Language Resources and Evaluation (LREC 2016), http://www.opensubtitles.org/

QUEST FOR FIRE Azpitituluak Euskaraz
Orain 80.000 urte gizakiaren iraupena lur ezezagunetan... sua eduki ala ez, horren araberakoa zen.
Hasierako gizaki haientzat, sua misterioa zen... inork ez baitzuen menderatu hura zelan sortu.
Sua naturari lapurtu, eta bizirik eusten zuten, babestuta haize, euri eta tribu aurkariengandik.
Sua boterearen sinboloa zen, eta irauteko bitartekoa.
Sua zeukan tribua, biziaren jabea zen.