# language_name_wals:	Hindi
# language_name_glotto:	Hindi
# iso639_3:	hin
# year_composed:	NA
# year_published:	NA
# mode:	written
# genre_broad:	technical
# genre_narrow:	NA
# writing_system:	Deva
# special_characters:	NA
# short_description:	KDE4
# source:	https://object.pouta.csc.fi/OPUS-KDE4/v2/raw/hi.zip
# copyright_short:	http://opus.nlpl.eu/KDE4.php
# copyright_long:	http://opus.nlpl.eu/KDE4.php J. Tiedemann, 2012, Parallel Data, Tools and Interfaces in OPUS. In Proceedings of the 8th International Conference on Language Resources and Evaluation (LREC 2012)
# sample_type:	whole
# comments:	NA

टीएलएस
सर्वर प्रमाणपत्र अवैध है. क्या आप जारी रखना चाहते हैं?
प्रमाणपत्र चेतावनी
लॉगइन विवरण सही नहीं हैं. क्या आप फिर से कोशिश करना चाहते हैं?