# language_name_wals:	Hindi
# language_name_glotto:	Hindi
# iso639_3:	hin
# year_composed:	NA
# year_published:	2010
# mode:	written
# genre_broad:	technical
# genre_narrow:	NA
# writing_system:	Deva
# special_characters:	NA
# short_description:	GNOME
# source:	https://object.pouta.csc.fi/OPUS-GNOME/v1/raw/hi.zip
# copyright_short:	http://opus.nlpl.eu/GNOME.php
# copyright_long:	http://opus.nlpl.eu/GNOME.php J. Tiedemann, 2012, Parallel Data, Tools and Interfaces in OPUS. In Proceedings of the 8th International Conference on Language Resources and Evaluation (LREC 2012)
# sample_type:	whole
# comments:	NA

उपयोक्ता विन्यास बदलें
तंत्र विन्यास प्रबंधित करें
इस उपयोक्ता विन्यास को बदलने में तंत्र नीति रोकती है
इस विन्यास को बदलने में तंत्र नीति रोकती है