# language_name_wals:	Russian
# language_name_glotto:	Russian
# iso639_3:	rus
# year_composed:	NA
# year_published:	NA
# mode:	written
# genre_broad:	technical
# genre_narrow:	NA
# writing_system:	Cyrl
# special_characters:	NA
# short_description:	PHP
# source:	https://object.pouta.csc.fi/OPUS-PHP/v1/raw/ru.zip
# copyright_short:	http://opus.nlpl.eu/PHP.php
# copyright_long:	http://opus.nlpl.eu/PHP.php J. Tiedemann, 2012, Parallel Data, Tools and Interfaces in OPUS. In Proceedings of the 8th International Conference on Language Resources and Evaluation (LREC 2012)
# sample_type:	whole
# comments:	NA

Руководство по PHP
Авторские права
Авторские права © Copyright 1997, 1998, 1999, 2000, 2001, 2002 принадлежат Группе Документирования PHP. Члены этой группы перечислены на первой странице руководства.
Данное руководство может распространяться на условиях лицензии GNU General Public License, опубликованной Free Software Foundation; подразумевается 2 версия лицензии или (на ваше усмотрение) любая более поздняя версия.
Авторские права © 2000 на главу "Расширение возможностей PHP 4.0" принадлежат Zend Technologies, Ltd. Этот материал может распространяться только на условиях лицензии Open Publication License, 1 версии или любой более поздней версии (самая последняя версия доступна по адресу http: / /www.opencontent.org / openpub /).
Начало