# language_name_wals:	Vietnamese
# language_name_glotto:	Vietnamese
# ISO_6393:	vie
# year_composed:	NA
# year_published:	NA
# mode:	written
# genre_broad:	technical
# genre_narrow:	NA
# writing_system:	Latn
# special_characters:	NA
# short_description:	KDE4
# source:	https://object.pouta.csc.fi/OPUS-KDE4/v2/raw/vi.zip
# copyright_short:	http://opus.nlpl.eu/KDE4.php
# copyright_long:	http://opus.nlpl.eu/KDE4.php J. Tiedemann, 2012, Parallel Data, Tools and Interfaces in OPUS. In Proceedings of the 8th International Conference on Language Resources and Evaluation (LREC 2012)
# sample_type:	whole
# comments:	NA

Không tìm thấy chương trình Perl trên hệ thống của bạn, xin hãy cài đặt.
Không tìm thấy chương trình Finger trên hệ thống của bạn, xin hãy cài đặt.
Không tìm thấy script ngôn ngữ Perl kio_ finger.
Không tìm thấy script ngôn ngữ CSS kio_ finger. Kết quả in ra trông sẽ xấu.