# language_name_wals:	Indonesian
# language_name_glotto:	Indonesian
# ISO_639-3:	ind
# year_composed:	NA
# year_published:	2017
# mode:	written
# genre_(broad):	non-fiction
# genre_(narrow):	prepared_speeches
# writing_system:	Latn
# special_characters:	NA
# short_description:	OpenSubtitles2018
# source:	https://object.pouta.csc.fi/OPUS-OpenSubtitles/v2018/raw/id.zip
# copyright_short:	http://www.opensubtitles.org/
# copyright_long:	http://www.opensubtitles.org/ P. Lison and J. Tiedemann, 2016, OpenSubtitles2016: Extracting Large Parallel Corpora from Movie and TV Subtitles. In Proceedings of the 10th International Conference on Language Resources and Evaluation (LREC 2016)
# sample_type:	whole
# comments:	NA

Subtitle by:

Kelihatannya ribut sudah berakhir.
Penduduk New York, dihujani hujan lebat malam tadi.
Angin bertiup kencang dan banjir di beberapa tempat malah ada penduduk New York