# language_name_wals:	Finnish
# language_name_glotto:	Finnish
# iso639_3:	fin
# year_composed:	NA
# year_published:	NA
# mode:	written
# genre_broad:	technical
# genre_narrow:	NA
# writing_system:	Latn
# special_characters:	NA
# short_description:	EMEA
# source:	https://object.pouta.csc.fi/OPUS-EMEA/v3/raw/fi.zip
# copyright_short:	http://opus.nlpl.eu/EMEA.php
# copyright_long:	http://opus.nlpl.eu/EMEA.php J. Tiedemann, 2012, Parallel Data, Tools and Interfaces in OPUS. In Proceedings of the 8th International Conference on Language Resources and Evaluation (LREC 2012)
# sample_type:	whole
# comments:	NA

LIITE
JÄSENVALTIOISSA TÄYTÄNTÖÖN PANTAVAT EHDOT TAI RAJOITUKSET, JOTKA KOSKEVAT KYSEISEN LÄÄKKEEN TURVALLISTA JA TEHOKASTA KÄYTTÖÄ JÄSENVALTIOISSA TÄYTÄNTÖÖN PANTAVAT EHDOT TAI RAJOITUKSET, JOTKA KOSKEVAT KYSEISEN LÄÄKKEEN TURVALLISTA JA TEHOKASTA KÄYTTÖÄ
Jäsenvaltiot varmistavat, että heidän jäsenvaltiossaan:
Myyntiluvan haltijan on varmistettava, että kaikki Lucentis- valmistetta mahdollisesti määräävät/ käyttävät lääkärit saavat markkinoille tuonnin yhteydessä tietopaketin, joka sisältää: • Tietoa lääkärille • Videon intravitreaalitoimenpiteestä • Kuvakaavion intravitreaalitoimenpiteestä • Tietopaketin potilaalle
Lääkärin tietopaketin tulee sisältää seuraavat keskeiset osat: • Valmisteyhteenveto • Aseptiikka, sisältäen silmän ympäryksen ja silmän pinnan desinfioinnin, tulehdusriskin pienentämiseksi • Antibioottien käyttö • Jodatun povidonin tai vastaavan käyttö • Silmän lasiaiseen annettavan injektion suoritustavat • Intravitreaali- injektioon liittyvien haittavaikutusten tärkeimmät löydökset ja oireet • Intravitreaali- injektioon liittyvien haittavaikutusten hoito
Potilaan tietopaketista tulee löytyä sekä potilasohjekirjanen että audio- CD sisältäen seuraavat perusasiat: • Potilaan tietolehtinen • Kuinka valmistautua Lucentis – toimenpiteeseen • Lucentis– injektion jälkeiset toimenpiteet • Vakavien haittavaikutusten tärkeimmät löydökset ja oireet • Milloin tulee hakea välittömästi apua terveydenhuoltohenkilöstöltä