# language_name_wals:	French
# language_name_glotto:	French
# ISO_639-3:	fra
# year_composed:	NA
# year_published:	2017
# mode:	written
# genre_(broad):	non-fiction
# genre_(narrow):	prepared speeches
# writing_system:	Latn
# special_characters:	NA
# short_description:	OpenSubtitles2018
# source:	https://object.pouta.csc.fi/OPUS-OpenSubtitles/v2018/raw/fr.zip
# copyright_short:	NA
# copyright_long:	NA
# sample_type:	whole
# comments:	P. Lison and J. Tiedemann, 2016, OpenSubtitles2016: Extracting Large Parallel Corpora from Movie and TV Subtitles. In Proceedings of the 10th International Conference on Language Resources and Evaluation (LREC 2016), http://www.opensubtitles.org/

Je m'appelle Oliver Queen.
Après cinq ans sur une île infernale, je suis rentré chez moi avec un seul but-- sauver ma ville.
Je mène ce combat sur deux fronts.
Le jour, je suis le maire de Star City, mais la nuit, je suis quelqu'un d'autre.
Je suis Green Arrow.
Précédemment dans "Arrow"...