# language_name_wals:	Spanish
# language_name_glotto:	Spanish
# iso639_3:	spa
# year_composed:	NA
# year_published:	2005
# mode:	written
# genre_broad:	conversation
# genre_narrow:	NA
# writing_system:	Latn
# special_characters:	NA
# short_description:	phon
# source:	https://phon.talkbank.org/data-orig/Biling/PhonBLA/spa/Individuals/360000.cha
# copyright_short:	https://sla.talkbank.org/TBB/phon
# copyright_long:	Phon and PhonBank: Rose, Y., & MacWhinney, B. (2014). The PhonBank Project: Data and software-assisted methods for the study of phonology and phonological development. In Durand J., Gut U., & Kristoffersen, G. (Eds.), The Oxford handbook of corpus phonology (pp. 380-401). Oxford, UK: Oxford University Press. Note: Please also acknowledge this grant support for PhonBank -- NIH-NICHHD RO1-HD051698.
# sample_type:	whole
# comments:	NA
La verdad que no estoy al tanto de eso , no estoy al tanto , un tema ese de política y además que está muy fuera de xxx en este sentido , no lo sé hablamos de la universidad ? 70000_83000
de vuestro proyecto quieres que hablemos ? 83000_85000
más cercanas ? 85000_88000
o de la escuela o de f y ahora hay menos hombre ahora otra vez vuelve , a ver , problemas con el tema de la , xxx con los niños por ejemplo nosotros tenemos un problema entre seis , en cero y tres tenemos mucha demanda y hay unas esperas enormes pero en tres seis los niños se van a los colegios . 88000_1690784