# language_name_wals:	Spanish
# language_name_glotto:	Spanish
# iso639_3:	spa
# year_composed:	NA
# year_published:	1998
# mode:	written
# genre_broad:	conversation
# genre_narrow:	NA
# writing_system:	Latn
# special_characters:	NA
# short_description:	CHILDES
# source:	https://childes.talkbank.org/data-orig/Spanish/GRERLI/University/pu02mnwa.cha
# copyright_short:	https://sla.talkbank.org/TBB/childes
# copyright_long:	MacWhinney, B. (2000). The CHILDES Project: Tools for analyzing talk. Third Edition. Mahwah, NJ: Lawrence Erlbaum Associates.
# sample_type:	whole
# comments:	NA
cuando yo tenía unos diez@n años .
paseaba con un amigo por la calle .
cuando a la persona que estaba delante se le cayó la cartera .
en ese momento la recogi .
y se la entregué al hombre 