# language_name_wals:	Spanish
# language_name_glotto:	Spanish
# iso639_3:	spa
# year_composed:	NA
# year_published:	1999
# mode:	written
# genre_broad:	conversation
# genre_narrow:	NA
# writing_system:	Latn
# special_characters:	NA
# short_description:	CHILDES
# source:	https://childes.talkbank.org/data-orig/Spanish/GRERLI/GradeSchool/pg07fnwb.cha
# copyright_short:	https://sla.talkbank.org/TBB/childes
# copyright_long:	MacWhinney, B. (2000). The CHILDES Project: Tools for analyzing talk. Third Edition. Mahwah, NJ: Lawrence Erlbaum Associates.
# sample_type:	whole
# comments:	NA
en mi clase ha muchas .
que se fijan en los demas .
pero el profesor no se entera .
porque los demas alumnos en estan en su
como se hace las cosas .
y los demas compa√±eros como ven que el profesor est