# language_name_wals:	Spanish
# language_name_glotto:	Spanish
# iso639_3:	spa
# year_composed:	NA
# year_published:	2009
# mode:	written
# genre_broad:	conversation
# genre_narrow:	NA
# writing_system:	Latn
# special_characters:	NA
# short_description:	CHILDES
# source:	https://childes.talkbank.org/data-orig/Clinical/CORDIS/moderate/Mlga12nfsx.cha
# copyright_short:	https://sla.talkbank.org/TBB/childes
# copyright_long:	MacWhinney, B. (2000). The CHILDES Project: Tools for analyzing talk. Third Edition. Mahwah, NJ: Lawrence Erlbaum Associates.
# sample_type:	whole
# comments:	NA
el chico acaba de pintar la(s) paredes .
estaba haciendo flores en la(s) paredes con pintura de un
luego estaba una niña muy enferma que le hacía flores .
(...) y luego sa emociona(d)o .
(..) sí 