# language_name_wals:	French
# language_name_glotto:	French
# iso639_3:	fra
# year_composed:	NA
# year_published:	1989
# mode:	written
# genre_broad:	conversation
# genre_narrow:	NA
# writing_system:	Latn
# special_characters:	NA
# short_description:	CHILDES
# source:	https://childes.talkbank.org/data-orig/French/Champaud/030129x.cha
# copyright_short:	https://sla.talkbank.org/TBB/childes
# copyright_long:	MacWhinney, B. (2000). The CHILDES Project: Tools for analyzing talk. Third Edition. Mahwah, NJ: Lawrence Erlbaum Associates.
# sample_type:	whole
# comments:	NA
une fois il y a quelqu'un qui est venu et je croyais que c'était
et c'était qui ?
et c'était toi .
c'était vrai que c'était toi 