# language_name_wals:	Thai
# language_name_glotto:	Thai
# iso639_3:	tha
# year_composed:	NA
# year_published:	NA
# mode:	written
# genre_broad:	technical
# genre_narrow:	NA
# writing_system:	Thai
# special_characters:	NA
# short_description:	KDE4
# source:	https://object.pouta.csc.fi/OPUS-KDE4/v2/raw/th.zip
# copyright_short:	http://opus.nlpl.eu/KDE4.php
# copyright_long:	http://opus.nlpl.eu/KDE4.php J. Tiedemann, 2012, Parallel Data, Tools and Interfaces in OPUS. In Proceedings of the 8th International Conference on Language Resources and Evaluation (LREC 2012)
# sample_type:	whole
# comments:	NA

% 1 ไม่มีโฟลเดอร์ส่วนตัว
ไม่มีผู้ใช้ที่ชื่อ% 1
ไม่มีแฟ้มหรือโฟลเดอร์% 1 อยู่
& ShortURLs