# language_name_wals:	Thai
# language_name_glotto:	Thai
# ISO_6393:	tha
# year_composed:	NA
# year_published:	2013
# mode:	written
# genre_broad:	technical
# genre_narrow:	NA
# writing_system:	Thai
# special_characters:	NA
# short_description:	Ubuntu
# source:	https://object.pouta.csc.fi/OPUS-Ubuntu/v14.10/raw/th.zip
# copyright_short:	http://opus.nlpl.eu/Ubuntu.php
# copyright_long:	http://opus.nlpl.eu/Ubuntu.php J. Tiedemann, 2012, Parallel Data, Tools and Interfaces in OPUS. In Proceedings of the 8th International Conference on Language Resources and Evaluation (LREC 2012)
# sample_type:	whole
# comments:	NA

คำเตือน: ดูเหมือนว่าคุณยังไม่ได้ติดตั้ง gstreamer0.10-plugins-good เลย
 คุณสมบัติทางวีดิทัศน์บางส่วนไม่สามารถทำงานได้
คำเตือน: ดูเหมือนว่าคุณยังไม่ได้ติดตั้งโปรแกรมเสริมส่วนหลักของ GStreamer
 ส่วนสนับสนุนด้านวีดิทัศน์และเสียงทั้งหมดไม่สามารถทำงานได้
ไม่พบสคริปต์ตัวช่วยการเข้า/ถอดรหัส