# language_name_wals:	Thai
# language_name_glotto:	Thai
# iso639_3:	tha
# year_composed:	NA
# year_published:	2014
# mode:	written
# genre_broad:	technical
# genre_narrow:	NA
# writing_system:	Thai
# special_characters:	NA
# short_description:	GNOME
# source:	https://object.pouta.csc.fi/OPUS-GNOME/v1/raw/th.zip
# copyright_short:	http://opus.nlpl.eu/GNOME.php
# copyright_long:	http://opus.nlpl.eu/GNOME.php J. Tiedemann, 2012, Parallel Data, Tools and Interfaces in OPUS. In Proceedings of the 8th International Conference on Language Resources and Evaluation (LREC 2012)
# sample_type:	whole
# comments:	NA

มอดูล GTK+ สำหรับการรองรับเทคโนโลยีสิ่งอำนวยความสะดวก
คีย์นี้กำหนดมอดูล GTK+ ที่จะโหลดเพื่อรองรับเทคโนโลยีสิ่งอำนวยความสะดวก
เรจิสตรี AT-SPI
เรจิสตรีระบบอำนวยการใช้งาน
โปรแกรมครอบเรจิสตรี AT SPI