# language_name_wals:	German
# language_name_glotto:	German
# iso639_3:	deu
# year_composed:	NA
# year_published:	NA
# mode:	written
# genre_broad:	conversation
# genre_narrow:	NA
# writing_system:	Latn
# special_characters:	NA
# short_description:	ca
# source:	https://ca.talkbank.org/data-orig/Bergmann/018_Fehlalarm.cha
# copyright_short:	https://sla.talkbank.org/TBB/ca
# copyright_long:	CABank: MacWhinney, B., & Wagner, J. (2010). Transcribing, searching and data sharing: The CLAN software and the TalkBank data repository. Gesprachsforschung, 11, 154-173.
# sample_type:	whole
# comments:	NA
feuerwehr↗ 280_770
komm se bitte schn▔e:ll▔ ∙hh (0.3) inn:::: ∙hhh ▔hertes▔
na na: be⌈stimmt⌉ net↘ 8050_9150
⌊&=legt_auf