# language_name_wals:	German
# language_name_glotto:	German
# iso639_3:	deu
# year_composed:	NA
# year_published:	2000
# mode:	written
# genre_broad:	conversation
# genre_narrow:	NA
# writing_system:	Latn
# special_characters:	NA
# short_description:	phon
# source:	https://phon.talkbank.org/data-orig/Biling/PhonBLA/deu/Simon/011008.cha
# copyright_short:	https://sla.talkbank.org/TBB/phon
# copyright_long:	Phon and PhonBank: Rose, Y., & MacWhinney, B. (2014). The PhonBank Project: Data and software-assisted methods for the study of phonology and phonological development. In Durand J., Gut U., & Kristoffersen, G. (Eds.), The Oxford handbook of corpus phonology (pp. 380-401). Oxford, UK: Oxford University Press. Note: Please also acknowledge this grant support for PhonBank -- NIH-NICHHD RO1-HD051698.
# sample_type:	whole
# comments:	NA
Jetzt werde ich Simon die Weste anlegen .
Was ist das ?
Wir gucken uns die Sachen an , die wir hier drin haben .
Was meinst du ?
Schiff , genau 