# language_name_wals:	Oromo (Harar)
# language_name_glotto:	Eastern Oromo
# iso639_3:	hae
# year_composed:	NA
# year_published:	2012
# mode:	written
# genre_broad:	technical
# genre_narrow:	NA
# writing_system:	Latn
# special_characters:	NA
# short_description:	Ubuntu
# source:	https://object.pouta.csc.fi/OPUS-Ubuntu/v14.10/raw/om.zip
# copyright_short:	http://opus.nlpl.eu/Ubuntu.php
# copyright_long:	http://opus.nlpl.eu/Ubuntu.php J. Tiedemann, 2012, Parallel Data, Tools and Interfaces in OPUS. In Proceedings of the 8th International Conference on Language Resources and Evaluation (LREC 2012)
# sample_type:	whole
# comments:	NA

UnknownMonitor vendor
namename
position", "size", and "maximum
requested", "minimummaximum
MirrorPantallas en Espejo", *not* "Espejar Pantallas