# language_name_wals:	Makah
# language_name_glotto:	Makah
# ISO_639-3:	myh
# year_composed:	NA
# year_published:	2010
# mode:	spoken
# genre_(broad):	non-fiction
# genre_(narrow):	oral tradition
# writing_system:	Latn
# special_characters:	special characters and diacritics are used but not further explained in the publication by Davidson & Werle (2010).
# short_description:	Helma Swan Ward recounts the prayers that she habitually recited. Title: The evening prayer.
# source:	Davidson, M. & Werle, A. (2010). Makah texts and analysis. In J. Dunham & J. Lyon (Eds.), Papers for the 45th International Conference on Salish and Neighbouring Languages. University of Columbia Working Papers in Linguistics (pp. 140-154).
# copyright_short:	NA
# copyright_long:	NA
# sample_type:	whole
# comments:	Sentences are given with an English translation.

<line_1>	ʔušuˑyakšʔalic hidiˑsis łax̌ ʔukʷiy , yaqaˑbitik ƛułuˑʔapsuˑ duˑbey , qʷaˑqeys ʔiyax̌ tiˑkaʔaˑ , huʔax̌ ƛ̓iˑʔak ʔiyax̌ kʷičiˑyeˑʔiqaˑd .
<translation>	Thank you for giving me this day , for the way you always make it good , for the way I’m here , still walking on this land .

<line_2>	ʔušuˑyakšʔalic ʔušuˑyakšʔalic .
<translation>	Thank you, thank you .