# language_name_wals:	Thai
# language_name_glotto:	Thai
# ISO_6393:	tha
# year_composed:	NA
# year_published:	2012
# mode:	written
# genre_broad:	non-fiction
# genre_narrow:	prepared_speeches
# writing_system:	Thai
# special_characters:	NA
# short_description:	OpenSubtitles2018
# source:	https://object.pouta.csc.fi/OPUS-OpenSubtitles/v2018/raw/th.zip
# copyright_short:	http://www.opensubtitles.org/
# copyright_long:	http://www.opensubtitles.org/ P. Lison and J. Tiedemann, 2016, OpenSubtitles2016: Extracting Large Parallel Corpora from Movie and TV Subtitles. In Proceedings of the 10th International Conference on Language Resources and Evaluation (LREC 2016)
# sample_type:	whole
# comments:	NA

นี่คือสิ่งที่คุณพลาดไปในกลี /ซูช่วย ให้ชมรมร้องเพลงชนะระดับประเทศ/ เพื่อที่ฟิกกินส์จะไม่ให้ ทีมเชียร์ลีดเดอร์กับรอซ วอชิงตัน /ผู้ได้รับเหรียญทองแดง ในการแข่งว่ายน้ำและพยายาม จะแย่งงานชาวบ้านชาวช่องเขา คุณจบสิ้นแล้ว แซมกับเมอร์เซดัสเคยเดตกันนิดหน่อย แต่เธอตัดความสัมพันธ์ด้วยการร้องเพลง และมันทำให้เขายอมถอยไปได้ เรเชลกับฟินน์เกือบจะได้แต่งงานกัน แต่พวกเขาทะเลาะกันยกใหญ่เพราะเรเชลอยาก ไปนิวยอร์ก และฟินน์อยากไปL.A. และเขาคิดว่าเธอคิดถึงแต่ตัวเธอเอง ซึ่งก็จริงนิดหน่อย และเธอก็คิดว่าเขาหลงทางนิดหน่อย ซึ่งก็จริงอย่างแน่นอน ความจริงแล้ว สมาชิกนิวไดเร็กชันส์ส่วนมากไม่รู้ว่าตนเองกำลังทำอะไรอยู่ และการจบการศึกษาก็ใกล้เข้ามาทุกที พวกเขาควรจะเปลี่ยนชื่อตนเองเป็นNo Directions(ไม่มีหนทาง) และนั้นคือสิ่งที่คุณพลาดไปในกลี (You Should Be Dancing โดย Bee Gees) คนรักของฉันเคลื่อนไหวตอนเที่ยงคืน ตามที่คิดไว้จนกว่าจะรุ่งเช้า เธอทำให้ฉันร่าเริง และทำให้ฉันอบอุ่น เธอกำลังทำอะไรกับหลังตัวเอง เธอทำอะไรกับหลังของเธอน่ะ อา เธอควรจะเต้นนะ เย้ เต้น เย้ เธอช่างเร้าใจและก็เป็นปัญหา เธอเอาสิ่งที่ดีให้ฉัน ให้พลังกับฉัน เข้าไปในสายลือด เธอทำอะไรกับหลังตัวเองน่ะ อา! เธอทำอะไรกับหลังตัวเองน่ะ อา! เธอควรจะเต้นนะ เย้ เต้น เย้ เธอทำอะไรกับหลังตัวเองน่ะ อา! เธอทำอะไรกับหลังตัวเองน่ะ Ha-ha-ha-ha เต้น เย้ เต้น เย้ เธอควรจะเต้นนะ เย้ เธอควรจะเต้นนะ เย้ Ha...

ยินดีด้วย พวกเธอสามคนคือผู้เข้ารอบสุดท้าย ของการแข่งเต้นSaturday Night Fever วู้! ที่นี่น่ะความเสี่ยงสูงนะ หนึ่งในพวกเธอจะเดินออกไป พร้อมกับสูทสีขาวของซู ฟังดูเยี่ยมสำหรับฉันนะ โอ้ เยี่ยม มันเป็นของเธอแล้ว พวกเราไปได้รึยังคะ โอเค ฟังนะ นี่ไม่ใช่เกี่ยวกับสูทจริงๆ มันเกี่ยวกับการทำตามความฝัน ของปีสุดท้ายทุกคนที่อยู่ในนิว ไดเร็คชันส์ พวกเธอสามคนยังไม่ได้ตัดสินใจเลย ว่าพวกเธออยากจะทำอะไรกับชีวิตของตนเอง ดังนั้น การบ้านของพวกเธอสำหรับสัปดาห์นี้ แสดงเพลงจากSaturday Night Feve และแบ่งปันความหวังของพวกเธอสำหรับอนาคต ไม่ เดี๋ยวนะ เรื่องพวกเต้นๆนี่กำหนดไว้แล้วเหรอ งั้น นี่มันอะไร ครูบางคนที่ ใช้เกมสารพัดเพื่อให้พวกเราบอกครูว่า พวกเราอยากเป็นอะไรตอนโตงั้นเหรอ เฮ้ ถ้าเธออยากมองแบบนั้นก็ได้ แต่นี่คือเกมของเธอ ชีวิตของเธอ ทายซิว่าอะไร เวลากำลังจะหมดแล้ว ครูชูเอาที่ไหนมาพูดให้ฉันฟัง ว่าจะมีความฝันได้ยังไง แค่เพราะฉันไม่ต้องการวิ่งไปนิวยอร์ก เหมือนเบอร์รี่และดาวเด่นในพวกฟื้นฟูศิลปะการแสดง ไม่ได้หมายความว่าฉันไม่รู้ว่าจะทำยังไงกับชีวิต และโทษทีนะ มีความฝันน่ะไม่ใช่ปัญหา ฉันมีความฝัน แค่ไม่รู้ว่าจะไปถึงที่นั่นได้ยังไงเท่านั้น ดังนั้น อย่าเข้าใจผิด เมอร์เซดีสโจนส์มีความปรารถนา และความทะเยอทะยานอย่างเร่าร้อนสุดๆ มันคือภูเขาไฟดีๆนี่แหละ (Disco Inferno

\ 1380 00:

บรรยายไทยโดย stdcc, ILoveKlaine, White7devil, The Moon, auntiesnix
Eric_Kibum, tumbomb94, JRSandy, meenie, TUMBy
johndevil, Peabieber, zaquariuz