# language_name_wals:	Tagalog
# language_name_glotto:	Tagalog
# ISO_639-3:	tgl
# year_composed:	NA
# year_published:	2004
# mode:	written
# genre_(broad):	fiction
# genre_(narrow):	general_fiction
# writing_system:	Latn
# special_characters:	NA
# short_description:    Gabriel Beato Francisco, Ang Katipunan
# source:	http://www.gutenberg.org/files/14205/14205-h/14205-h.htm
# copyright_short:	http://www.gutenberg.org
# copyright_long:	http://www.gutenberg.org
# sample_type:	whole
# comments:	NA

    Pag-hinto nang-auit ay muling magsisitaban nang copa at saca
paguiguitna ang calahatan.
Mga katipunan: ang ilan ay naglilinis ng pusil, ang ilan naman
ay nagsasayauan at nag-aauitan at ang ilang babaye ay naliligo sa
batis.
