# language_name_wals:	Persian
# language_name_glotto:	Western Farsi
# ISO_6393:	pes
# year_composed:	NA
# year_published:	NA
# mode:	written
# genre_broad:	technical
# genre_narrow:	NA
# writing_system:	Arab
# special_characters:	NA
# short_description:	KDE4
# source:	https://object.pouta.csc.fi/OPUS-KDE4/v2/raw/fa.zip
# copyright_short:	http://opus.nlpl.eu/KDE4.php
# copyright_long:	http://opus.nlpl.eu/KDE4.php J. Tiedemann, 2012, Parallel Data, Tools and Interfaces in OPUS. In Proceedings of the 8th International Conference on Language Resources and Evaluation (LREC 2012)
# sample_type:	whole
# comments:	NA

نمایش سیاستهای امنیتی PAM
خدمات موجود:
دسته
سطح
پیمانه
پوشۀ / etc/ pam. d موجود نیست. یا سیستم شما دارای پشتیبانی PAM نیست ، یا مسئلۀ پیکربندی دیگری وجود دارد.