# language_name_wals:	Persian
# language_name_glotto:	Western Farsi
# iso639_3:	pes
# year_composed:	NA
# year_published:	2012
# mode:	written
# genre_broad:	technical
# genre_narrow:	NA
# writing_system:	Arab
# special_characters:	NA
# short_description:	GNOME
# source:	https://object.pouta.csc.fi/OPUS-GNOME/v1/raw/fa.zip
# copyright_short:	http://opus.nlpl.eu/GNOME.php
# copyright_long:	http://opus.nlpl.eu/GNOME.php J. Tiedemann, 2012, Parallel Data, Tools and Interfaces in OPUS. In Proceedings of the 8th International Conference on Language Resources and Evaluation (LREC 2012)
# sample_type:	whole
# comments:	NA

atk-bridge: نمی‌توان به کارگزار dbus گوش سپرد: %s
فعال‌سازی زیربنا AT-SPI مبتنی بر DBus
ماژول‌های +GTK برای پشتیبانی از امکانات دسترسی‌پذیری
در ترکیب با desktop/gnome/interface/accessibility/، چناچه زیربنا AT-SPI مبتنی بر DBus جابجا شده باشد، این کلید برای فعال‌سازی زیربنا AT-SPI مبتنی بر DBus لازم است. اگر زیر بنا AT-SPI مبتنی بر DBus جابجا نشده باشد، این مورد نادیده گرفته می‌شود.
این کلید ماژول‌های +GTK را برای بار کردن پشتیبانی از امکانات دسترسی‌پذیری تعریف می‌کند.