# language_name_wals:	Kannada
# language_name_glotto:	Kannada
# ISO_6393:	kan
# year_composed:	NA
# year_published:	2012
# mode:	written
# genre_broad:	technical
# genre_narrow:	NA
# writing_system:	Knda
# special_characters:	NA
# short_description:	GNOME
# source:	https://object.pouta.csc.fi/OPUS-GNOME/v1/raw/kn.zip
# copyright_short:	http://opus.nlpl.eu/GNOME.php
# copyright_long:	http://opus.nlpl.eu/GNOME.php J. Tiedemann, 2012, Parallel Data, Tools and Interfaces in OPUS. In Proceedings of the 8th International Conference on Language Resources and Evaluation (LREC 2012)
# sample_type:	whole
# comments:	NA

atk-bridge: dbus ಪರಿಚಾರಕದಲ್ಲಿ ಆಲಿಸಲು ಸಾಧ್ಯವಾಗಿಲ್ಲ: %s
DBus-ಆಧರಿತವಾದ AT-SPI ಮೂಲ ಸೌಕರ್ಯ
ನಿಲುಕಣಾ ಬೆಂಬಲಕ್ಕಾಗಿ GTK+ ಮಾಡ್ಯೂಲ್‌ಗಳು
DBus-ಆಧರಿತವಾದ AT-SPI ಮೂಲ ಸೌಕರ್ಯದ ಸ್ಥಳವನ್ನು ಬದಲಾಯಿಸಿದಲ್ಲಿ DBus-ಆಧರಿತವಾದ AT-SPI ಅನ್ನು ಶಕ್ತಗೊಳಿಸಲು /desktop/gnome/interface/accessibility ಯ ಜೊತೆಗೆ ಈ ಕೀಲಿಯ ಅಗತ್ಯವಿರುತ್ತದೆ. DBus-ಆಧರಿತವಾದ AT-SPI ಮೂಲ ಸೌಕರ್ಯದ ಸ್ಥಳವನ್ನು ಬದಲಾಯಿಸದೆ ಇದ್ದಲ್ಲಿ ಇದನ್ನು ಕಡೆಗಣಿಸಲಾಗುತ್ತದೆ.
ನಿಲುಕಣಾ ಬೆಂಬಲಕ್ಕಾಗಿ GTK+ ಮಾಡ್ಯೂಲ್‌ಗಳನ್ನು ಲೋಡ್‌ ಮಾಡುವುದನ್ನು ಈ ಕೀಲಿಯು ನಿರ್ಧರಿಸುತ್ತದೆ.