# language_name_wals:	Kannada
# language_name_glotto:	Kannada
# ISO_6393:	kan
# year_composed:	NA
# year_published:	NA
# mode:	written
# genre_broad:	technical
# genre_narrow:	NA
# writing_system:	Knda
# special_characters:	NA
# short_description:	KDE4
# source:	https://object.pouta.csc.fi/OPUS-KDE4/v2/raw/kn.zip
# copyright_short:	http://opus.nlpl.eu/KDE4.php
# copyright_long:	http://opus.nlpl.eu/KDE4.php J. Tiedemann, 2012, Parallel Data, Tools and Interfaces in OPUS. In Proceedings of the 8th International Conference on Language Resources and Evaluation (LREC 2012)
# sample_type:	whole
# comments:	NA

% 1 ಚಿಹ್ನೆಯ ಸಂಯೋಜನೆಗಳು@ action: inmenu
ಇಲ್ಲಿಗೆ ಸಾಗಿಸು (M)\ t% 1 @ action: inmenu
ಇಲ್ಲಿಗೆ ನಕಲಿಸು (C)\ t% 1 @ action: inmenu
ಇದಕ್ಕೆ ಸಂಪರ್ಕಕೊಂಡಿ ಜೋಡಿಸು (L)\ t% 1 @ action: inmenu
ರದ್ದುಮಾಡು