# language_name_wals:	Indonesian
# language_name_glotto:	Indonesian
# ISO_6393:	ind
# year_composed:	NA
# year_published:	NA
# mode:	written
# genre_broad:	technical
# genre_narrow:	NA
# writing_system:	Latn
# special_characters:	NA
# short_description:	KDE4
# source:	https://object.pouta.csc.fi/OPUS-KDE4/v2/raw/id.zip
# copyright_short:	http://opus.nlpl.eu/KDE4.php
# copyright_long:	http://opus.nlpl.eu/KDE4.php J. Tiedemann, 2012, Parallel Data, Tools and Interfaces in OPUS. In Proceedings of the 8th International Conference on Language Resources and Evaluation (LREC 2012)
# sample_type:	whole
# comments:	NA

Jangan lakukan apa- apaA default name for an action without proper label
Tak diketahui
Divais baru telah terdeteksi. Apa yang ingin anda lakukan?
...
'% 1' memerlukan sandi untuk dapat diakses. Silakan masukkan sandi.